Total PathPoint,16,Columns,16,Rows,9,,,,,,,,,,
1,1,1,1,1,1,1,1,1,4,1,1,1,1,1,1
1,1,6,3,3,3,3,3,3,5,2,1,1,1,1,1
1,1,3,2,2,2,2,2,2,2,2,2,2,2,1,1
1,1,7,8,2,11,3,12,2,15,3,16,2,2,1,1
1,1,2,3,2,3,2,3,2,3,2,3,2,19,20,4
1,1,2,3,2,3,2,3,2,3,2,3,2,3,2,1
1,1,2,3,2,3,2,3,2,3,2,3,2,3,2,1
1,1,2,3,2,3,2,3,2,3,2,3,2,3,2,1
1,1,2,9,3,10,2,13,3,14,2,17,3,18,2,1