Total PathPoint,11,Columns,16,Rows,9,,,,,,,,,,
1,1,1,1,1,1,1,1,1,4,1,1,1,1,1,1
1,1,2,2,2,2,2,2,2,9,2,1,1,1,1,1
1,1,2,11,3,3,3,3,3,10,2,2,2,2,1,1
1,1,2,3,5,2,7,2,7,2,5,2,2,2,1,1
1,1,2,12,3,3,3,3,3,3,3,13,6,18,19,4
1,1,2,2,8,2,2,6,2,2,2,3,2,3,2,1
1,1,2,15,3,3,3,3,3,3,3,14,2,3,2,1
1,1,2,3,2,8,2,2,5,2,5,2,2,3,2,1
1,1,2,16,3,3,3,3,3,3,3,3,3,17,2,1