1,1,1,1,1,1,1,1,1,4,1,1,1,1,1,1
1,1,1,2,1,2,1,2,1,5,1,1,1,1,1,1
1,1,1,7,3,3,3,3,3,6,1,1,1,1,1,1
1,1,1,3,1,1,1,2,1,1,2,1,1,1,1,1
1,1,1,8,3,3,3,3,3,3,3,9,1,14,15,4
1,1,1,2,1,1,1,2,1,1,1,3,2,3,1,1
1,1,1,11,3,3,3,3,3,3,3,10,1,3,2,1
1,1,1,3,1,1,2,1,2,1,1,1,2,3,1,1
1,1,1,12,3,3,3,3,3,3,3,3,3,13,1,1