Total PathPoint,11,Columns,16,Rows,9,,,,,,,,,,
1,1,1,1,1,1,1,1,1,4,1,1,1,1,1,1
1,1,2,2,2,2,2,2,2,5,2,1,1,1,1,1
1,1,2,7,3,3,3,3,3,6,2,2,2,2,1,1
1,1,2,3,2,2,2,2,2,2,2,2,2,2,1,1
1,1,2,8,3,3,3,3,3,3,3,9,2,14,15,4
1,1,2,2,2,2,2,2,2,2,2,3,2,3,2,1
1,1,2,11,3,3,3,3,3,3,3,10,2,3,2,1
1,1,2,3,2,2,2,2,2,2,2,2,2,3,2,1
1,1,2,12,3,3,3,3,3,3,3,3,3,13,2,1