Total PathPoint,17,Columns,16,Rows,9,,,,,,,,,,
1,1,1,1,1,1,1,1,1,1,1,1,1,1,1,1
1,1,2,2,2,2,2,2,18,3,17,1,1,1,1,1
1,1,2,8,3,3,7,2,3,2,16,3,3,15,1,1
1,1,2,3,2,2,3,2,19,20,2,2,2,3,1,1
1,1,2,3,2,2,6,5,2,21,4,2,2,3,2,1
1,1,2,3,2,2,2,2,2,2,2,2,2,3,2,1
1,1,2,3,2,2,11,3,12,2,2,2,2,3,2,1
1,1,2,3,2,2,3,2,13,3,3,3,3,14,2,1
1,1,2,9,3,3,10,2,2,2,2,2,2,2,2,1