Total PathPoint,16,Columns,16,Rows,9,,,,,,,,,,
1,1,1,1,1,1,1,1,1,1,1,1,1,1,1,1
1,1,2,2,2,2,2,8,21,3,20,1,1,1,1,1
1,1,2,11,3,3,10,2,3,8,19,3,3,18,1,1
1,1,7,3,2,7,3,2,22,23,2,5,2,3,1,1
1,1,2,3,5,2,9,4,2,24,4,2,2,3,1,1
1,1,5,3,2,6,8,2,7,2,2,5,2,3,1,1
1,1,1,3,7,2,14,3,15,6,2,2,2,3,1,1
1,1,1,3,2,8,3,2,16,3,3,3,3,17,1,1
1,1,1,12,3,3,13,2,2,7,2,2,7,2,1,1