Total PathPoint,16,Columns,16,Rows,9,,,,,,,,,,
1,1,1,1,1,1,1,1,1,4,1,1,1,1,1,1
1,1,2,2,2,2,2,2,2,9,2,1,1,1,1,1
1,1,2,11,3,3,3,3,3,10,2,22,3,21,1,1
1,1,2,3,5,2,2,6,2,2,6,3,2,3,1,1
1,1,2,3,2,15,3,3,3,14,2,23,3,3,24,4
1,1,2,3,5,3,2,8,2,3,7,2,8,3,2,1
1,1,2,3,2,16,3,3,3,17,3,18,2,3,2,1
1,1,2,3,2,6,2,7,2,3,2,3,8,3,2,1
1,1,2,12,3,3,3,3,3,13,2,19,3,20,2,1